Diamond Palace
33333333333333333
33400003930000033
34000000500000003
30000000000000003
30002200000220003
30002666466620003
30004600000640003
30004670000640003
30002666466620003
30002200000220003
33000000000000033
33333333333333333
BoulderStruck
33333333333333333
30000073330000333
30000003300000033
30066004006666003
30000004000666003
30400403300000733
30044003334333333
30066003330333303
30000003330300403
30000003330334343
37000003300040453
39333333333330333
Nameless
33333333333333333
30000000000000003
36663002222000333
33333002662000633
30074000000000333
36000405000000333
37004000000000333
33333002662000333
30000442222000633
30600000000000333
30070300000000093
33333333333333333
Shoot! Shooters!
33333333333333333
35000400800000003
30040000300606003
30400000800060003
30004000300606003
30000000870000003
30022222222222003
30000000000000003
30022200400222003
30022200400222003
30000000000000003
33333333933333333
Spider Drive
11111111111111111
16000000000000061
10222220002222201
10008000000080001
10222220002222201
15002000000020001
10000000000000001
10000001110000001
10101001900010101
10141061116014101
10001700000710001
11111111111111111
Roundabout
00033333333300000
00030000000300000
00030644460300000
00037400047300000
00030405040300000
00030400040300000
00030644460300000
00030070000300000
00033339333300222
00000000000000240
00000000000000240
00000000000000200
No use of a name
33333333333333333
37037037037037009
30030030030030003
36636636636636633
30000000000000003
30000000000000003
30002222022220003
35000000600040003
30002222022220003
80000000000000008
30000000600000003
33333333333333333
Spider Carnage
22222222922222222
20000000000000002
20333333033333302
20470063036007402
20400063036000402
20333333033333302
20000500000000002
20333333033333302
20470063036070402
20400063036000402
20333333033333302
22222222222222222
Gettaway
22222222222222222
20070151111000002
40111101161726204
40000001701022204
22011040001026202
20071466411000702
20001044001110112
20001701040000002
40001111404000004
46001191404000014
20000000000000114
22222222222222222
Boulder Carnage
11111111111111111
14540404040404641
10404040404040001
10040404040404001
10404040004040401
14040400400404041
10404040004040401
10040404040404001
10404040404040401
14040404040404041
16004040404040061
11111119111111111
Dot, or not
11111111111111111
10040019160006001
10674000111006071
10004500661006001
11111100111001111
10000100000001661
17330000000011001
10330111111118001
10070100160000001
11001100460000001
16000000000000001
11111111111111111
Round and round
22222222222222222
20000000000000072
27303030303036302
20343030303030302
27000000000000702
22222222222220222
25000920000000002
20222220000200002
20000740000200002
20262020000800002
27000026006260062
22222222222222222
Half empty
33333333333333333
30000000600000763
30400400000000003
30044003800000083
30000073000000003
33333333000000003
00003073800000083
33333004000400003
30000004000000003
30333003600000063
35333333333333333
39300000000000003
Partly Piramid
33333333333333333
30000000000000063
37007007007007063
36666666111111143
30000001519000063
37007010001000403
36000100000100003
30001000000010003
30010000000001003
30100000000000003
30000000000000003
33333333333333333
Spider pockets
33333333333333333
87006000500060078
36666000040066663
34000000000000043
36666000000066663
87006000000060078
36666004000066663
30000000000000003
36666002920066663
87006002220060078
36666000000066663
33333333333333333
Lastly Little Level
11111111111111111
16000000000000761
17111111611111101
10160000000076101
10171111611110101
10101000504010101
10101040000010101
10101111611117101
10167000000006101
10111111611111171
16700000000000061
11111111911111111